28,25,19,20,10,26,21,29,6,24,11,10,7,12,20,21,28,7
13,17,32,23,17,18,19,9,15,27,24,35,16,21,6,15,25,2
11,12,13,32,26,7,23,19,30,16,17,10,24,18,21,22,26,25
13,24,14,26,7,5,25,12,15,16,17,18,19,22,1,13,14,18
28,34,35,20,3,8,31,32,14,33,10,4,5,23,11,20,0,12
33,34,15,8,29,30,31,22,27,32,9,6,0,1,2,3,4,11
14,33,34,9,3,28,4,5,6,27,35,0,1,30,8,29,2,31
29,9,2,8,3,4,5,33,30,31,16,23,34,35,0,27,22,1
